########################################################################################################################################################################################################
#                                                                                                                                                                                                      #
#                                                                                                                                                                                                      #
#                                                                                                                                                                                                      #
#                                                                                                                                                                                                      #
#                                                                                                                                                                                                      #
#                                                                                                                                                                                                      #
#                                                                                                                                                                                                      #
#                                                                                                                                                                                                      #
#                                                                                                                                                                                                      #
#                                                 #                                                                                                                                                    #
#                                                 #                                                                                                                                                    #
#                                                 #                                                                                                                                                    #
#                                                 #                                                                                                                                                    #
#                                                 #                                                                                                                                                    #
#                    ############################################################                                                                                                                      #
#                                                 #                                                                                                                                                    #
#                                                 #                                                                                                                                                    #
#                                                 #                                                                                                                                                    #
#                                                 #                                                                                                                                                    #
#                                                 #                                                                                                                                                    #
#                                                 #                                                                                                                                                    #
#                                                 #                                                                                                                                                    #
#                                                 #                                                                                                                                                    #
#                                                 #                                                                                                                                                    #
#                                                 #                                                                               #                                                                    #
#                                                 #                                                                               #                                                                    #
#                                                 #                                                                               #                                                                    #
#                                                 #                                                                               #                                                                    #
#                                                 #                                                                               #                                                                    #
#                                                 #                                                                               #                                                                    #
#                                                                                                                                 #                                                                    #
#                                                                                                                                 #                                                                    #
#                                                                                                                                 #                                                                    #
#                                                                                                                                 #                                                                    #
#                                                                                                                                 #                                                                    #
#                                                                                                                                 #                                                                    #
#                                                                                                                                 #                                                                    #
#                                                                                                                                 #                                                                    #
#                                                                                                                                 #                                                                    #
#                                                                                                    ############################################################                                      #
#                                                                                                                                 #                                                                    #
#                                                                                                                                 #                                                                    #
#                                                                                                                                 #                                                                    #
#                                                                                                                                 #                                                                    #
#                                                                                                                                 #                                                                    #
#                                                                                                                                 #                                                                    #
#                                                                                                                                 #                                                                    #
#                                                                                                                                 #                                                                    #
#                                                                                                                                 #                                                                    #
#                                                                                                                                 #                                                                    #
#                                                                                                                                                                                                      #
#                                                                                                                                                                                                      #
#                                                                                                                                                                                                      #
#                                                                                                                                                                                                      #
#                                                                                                                                                                                                      #
#                                                                                                                                                                                                      #
#                                                                                                                                                                                                      #
#                                                                                                                                                                                                      #
########################################################################################################################################################################################################